{
  "layout": [
    "##############################",
    "#                            #",
    "#                            #",
    "#                            #",
    "#                            #",
    "L                            R",
    "L                            R",
    "L                            R",
    "##############################",
    "######                  ######",
    "###                        ###",
    "##                          ##",
    "##                          ##",
    "L                            R",
    "L                            R",
    "L                            R",
    "##############################"
  ],
  "enemies": [],
  "items": [],
  "players": [],
  "exits": [],
  "teleports": [],
  "music": null
}