{
  "layout": [
    "##############################",
    "#                            #",
    "#                            #",
    "#                            #",
    "#                            #",
    "#                            #",
    "#                            #",
    "#                            #",
    "#                            #",
    "#                            #",
    "#                            #",
    "#                            #",
    "#                            #",
    "#                            R",
    "#                            R",
    "#                            R",
    "##############################"
  ],
  "enemies": [],
  "items": [],
  "players": [],
  "exits": [],
  "teleports": [],
  "music": null
}